SNG ="countries/Senegal.txt" 
SNB ="countries/SenegalSNB.txt"
SNO ="countries/SenegalSNO.txt"
BHP ="countries/Bahawalpur.txt" 
BHZ ="countries/BahawalpurBHZ.txt"
BHS ="countries/BahawalpurBHS.txt"
ALT ="countries/AltaiRepublic.txt" 
ALI ="countries/AltaiRepublicALI.txt"
ALX ="countries/AltaiRepublicALX.txt"
MRU ="countries/MaritimeUnion.txt" 
MRV ="countries/MaritimeUnionMRV.txt"
MRN ="countries/MaritimeUnionMRN.txt"
HNN ="countries/Hunan.txt" 
HNT ="countries/HunanHNT.txt"
HNC ="countries/HunanHNC.txt"
TRS ="countries/Tarasco.txt" 
TRD ="countries/TarascoTRD.txt"
TRU ="countries/TarascoTRU.txt"
SOK ="countries/Sokoto.txt" 
SOY ="countries/SokotoSOY.txt"
SOI ="countries/SokotoSOI.txt"
TUR ="countries/OttomanEmpire.txt" 
TUI ="countries/OttomanEmpireTUI.txt"
TUZ ="countries/OttomanEmpireTUZ.txt"
UNM ="countries/NewMexico.txt" 
UNA ="countries/NewMexicoUNA.txt"
UNO ="countries/NewMexicoUNO.txt"
CHP ="countries/Chiapas.txt" 
CHE ="countries/ChiapasCHE.txt"
CHH ="countries/ChiapasCHH.txt"
TRZ ="countries/Trarza.txt" 
TRK ="countries/TrarzaTRK.txt"
TRB ="countries/TrarzaTRB.txt"
AZA ="countries/Azande.txt" 
AZY ="countries/AzandeAZY.txt"
AZT ="countries/AzandeAZT.txt"
WRI ="countries/Warri.txt" 
WRU ="countries/WarriWRU.txt"
WRS ="countries/WarriWRS.txt"
MGL ="countries/Mongolia.txt" 
MGP ="countries/MongoliaMGP.txt"
MGD ="countries/MongoliaMGD.txt"
GLM ="countries/Galicia-Lodomeria.txt" 
GLS ="countries/Galicia-LodomeriaGLS.txt"
GLJ ="countries/Galicia-LodomeriaGLJ.txt"
BHR ="countries/Bahrain.txt" 
BHC ="countries/BahrainBHC.txt"
BHI ="countries/BahrainBHI.txt"
LBG ="countries/Limburg.txt" 
LBQ ="countries/LimburgLBQ.txt"
LBZ ="countries/LimburgLBZ.txt"
VEN ="countries/Venice.txt" 
VEQ ="countries/VeniceVEQ.txt"
VEA ="countries/VeniceVEA.txt"
SID ="countries/Sidama.txt" 
SIT ="countries/SidamaSIT.txt"
SIP ="countries/SidamaSIP.txt"
PNJ ="countries/Panjab.txt" 
PNX ="countries/PanjabPNX.txt"
PNW ="countries/PanjabPNW.txt"
SIK ="countries/Sikkim.txt" 
SIH ="countries/SikkimSIH.txt"
SIQ ="countries/SikkimSIQ.txt"
GLC ="countries/Galicia.txt" 
GLF ="countries/GaliciaGLF.txt"
GLG ="countries/GaliciaGLG.txt"
GUY ="countries/Guyana.txt" 
GUL ="countries/GuyanaGUL.txt"
GUW ="countries/GuyanaGUW.txt"
CHI ="countries/China.txt" 
CHX ="countries/ChinaCHX.txt"
CHS ="countries/ChinaCHS.txt"
SRD ="countries/Sardinia.txt" 
SRW ="countries/SardiniaSRW.txt"
SRU ="countries/SardiniaSRU.txt"
NAL ="countries/Natalia.txt" 
NAK ="countries/NataliaNAK.txt"
NAF ="countries/NataliaNAF.txt"
DLM ="countries/Dalmatia.txt" 
DLI ="countries/DalmatiaDLI.txt"
DLX ="countries/DalmatiaDLX.txt"
GEL ="countries/Geledi.txt" 
GEX ="countries/GelediGEX.txt"
GEN ="countries/GelediGEN.txt"
GAZ ="countries/Gaza.txt" 
GAV ="countries/GazaGAV.txt"
GAE ="countries/GazaGAE.txt"
GCO ="countries/GranColombia.txt" 
GCL ="countries/GranColombiaGCL.txt"
GCN ="countries/GranColombiaGCN.txt"
DAM ="countries/Damagaram.txt" 
DAE ="countries/DamagaramDAE.txt"
DAN ="countries/DamagaramDAN.txt"
KMK ="countries/Kalmykia.txt" 
KMX ="countries/KalmykiaKMX.txt"
KMM ="countries/KalmykiaKMM.txt"
TGA ="countries/Tonga.txt" 
TGQ ="countries/TongaTGQ.txt"
TGE ="countries/TongaTGE.txt"
DUR ="countries/DurraniEmpire.txt" 
DUL ="countries/DurraniEmpireDUL.txt"
DUT ="countries/DurraniEmpireDUT.txt"
SIB ="countries/SiberianRepublic.txt" 
SIJ ="countries/SiberianRepublicSIJ.txt"
SIM ="countries/SiberianRepublicSIM.txt"
SBA ="countries/BuenosAires.txt" 
SBS ="countries/BuenosAiresSBS.txt"
SBP ="countries/BuenosAiresSBP.txt"
MOS ="countries/Mossi.txt" 
MOJ ="countries/MossiMOJ.txt"
MOT ="countries/MossiMOT.txt"
SWK ="countries/Sarawak.txt" 
SWG ="countries/SarawakSWG.txt"
SWL ="countries/SarawakSWL.txt"
SYR ="countries/Syria.txt" 
SYU ="countries/SyriaSYU.txt"
SYM ="countries/SyriaSYM.txt"
BSH ="countries/Basotho.txt" 
BSV ="countries/BasothoBSV.txt"
BSK ="countries/BasothoBSK.txt"
BYE ="countries/Belarus.txt" 
BYJ ="countries/BelarusBYJ.txt"
BYS ="countries/BelarusBYS.txt"
SAX ="countries/Saxony.txt" 
SAP ="countries/SaxonySAP.txt"
SAE ="countries/SaxonySAE.txt"
FSA ="countries/FreeStatesofAmerica.txt" 
FSY ="countries/FreeStatesofAmericaFSY.txt"
FSP ="countries/FreeStatesofAmericaFSP.txt"
BUR ="countries/Burma.txt" 
BUH ="countries/BurmaBUH.txt"
BUX ="countries/BurmaBUX.txt"
LAN ="countries/Lanfang.txt" 
LAK ="countries/LanfangLAK.txt"
LAX ="countries/LanfangLAX.txt"
SIE ="countries/Siebenburgen.txt" 
SIF ="countries/SiebenburgenSIF.txt"
SIR ="countries/SiebenburgenSIR.txt"
AGC ="countries/Angoche.txt" 
AGM ="countries/AngocheAGM.txt"
AGH ="countries/AngocheAGH.txt"
BUL ="countries/Bulgaria.txt" 
BUU ="countries/BulgariaBUU.txt"
BUM ="countries/BulgariaBUM.txt"
CAM ="countries/Cambodia.txt" 
CAZ ="countries/CambodiaCAZ.txt"
CAS ="countries/CambodiaCAS.txt"
SRI ="countries/SriLanka.txt" 
SRE ="countries/SriLankaSRE.txt"
SRS ="countries/SriLankaSRS.txt"
TAJ ="countries/Tajikstan.txt" 
TAA ="countries/TajikstanTAA.txt"
TAL ="countries/TajikstanTAL.txt"
KLM ="countries/Kalimantan.txt" 
KLF ="countries/KalimantanKLF.txt"
KLH ="countries/KalimantanKLH.txt"
OLD ="countries/Oldenburg.txt" 
OLP ="countries/OldenburgOLP.txt"
OLU ="countries/OldenburgOLU.txt"
TTB ="countries/Trinidad.txt" 
TTZ ="countries/TrinidadTTZ.txt"
TTQ ="countries/TrinidadTTQ.txt"
BNB ="countries/Baban.txt" 
BNW ="countries/BabanBNW.txt"
BNZ ="countries/BabanBNZ.txt"
ARA ="countries/Arabia.txt" 
ARL ="countries/ArabiaARL.txt"
ARE ="countries/ArabiaARE.txt"
INO ="countries/Indonesia.txt" 
INX ="countries/IndonesiaINX.txt"
INV ="countries/IndonesiaINV.txt"
CLM ="countries/Colombia.txt" 
CLZ ="countries/ColombiaCLZ.txt"
CLW ="countries/ColombiaCLW.txt"
KMT ="countries/NationalistChina.txt" 
KMH ="countries/NationalistChinaKMH.txt"
KMC ="countries/NationalistChinaKMC.txt"
BKV ="countries/Bukovina.txt" 
BKC ="countries/BukovinaBKC.txt"
BKA ="countries/BukovinaBKA.txt"
KYR ="countries/Kyrgyzstan.txt" 
KYW ="countries/KyrgyzstanKYW.txt"
KYH ="countries/KyrgyzstanKYH.txt"
NEP ="countries/Nepal.txt" 
NEH ="countries/NepalNEH.txt"
NEK ="countries/NepalNEK.txt"
TNT ="countries/TannuTuva.txt" 
TNA ="countries/TannuTuvaTNA.txt"
TNM ="countries/TannuTuvaTNM.txt"
RGS ="countries/RioGrandedoSul.txt" 
RGN ="countries/RioGrandedoSulRGN.txt"
RGF ="countries/RioGrandedoSulRGF.txt"
GMJ ="countries/Guominjun.txt" 
GMZ ="countries/GuominjunGMZ.txt"
GMX ="countries/GuominjunGMX.txt"
PHL ="countries/Philippines.txt" 
PHQ ="countries/PhilippinesPHQ.txt"
PHH ="countries/PhilippinesPHH.txt"
KML ="countries/Kumul.txt" 
KMN ="countries/KumulKMN.txt"
KMW ="countries/KumulKMW.txt"
BLZ ="countries/Belize.txt" 
BLO ="countries/BelizeBLO.txt"
BLH ="countries/BelizeBLH.txt"
BAH ="countries/Bahia.txt" 
BAG ="countries/BahiaBAG.txt"
BAT ="countries/BahiaBAT.txt"
CHL ="countries/Chile.txt" 
CHZ ="countries/ChileCHZ.txt"
CHG ="countries/ChileCHG.txt"
LAT ="countries/Latvia.txt" 
LAL ="countries/LatviaLAL.txt"
LAQ ="countries/LatviaLAQ.txt"
KON ="countries/Kongo.txt" 
KOS ="countries/KongoKOS.txt"
KOV ="countries/KongoKOV.txt"
RUT ="countries/Ruthenia.txt" 
RUU ="countries/RutheniaRUU.txt"
RUV ="countries/RutheniaRUV.txt"
JAL ="countries/Jallon.txt" 
JAN ="countries/JallonJAN.txt"
JAQ ="countries/JallonJAQ.txt"
BHU ="countries/Bhutan.txt" 
BHD ="countries/BhutanBHD.txt"
BHE ="countries/BhutanBHE.txt"
MAL ="countries/Maluku.txt" 
MAC ="countries/MalukuMAC.txt"
MAF ="countries/MalukuMAF.txt"
KTH ="countries/Kathiri.txt" 
KTN ="countries/KathiriKTN.txt"
KTG ="countries/KathiriKTG.txt"
MOL ="countries/Moldavia.txt" 
MOG ="countries/MoldaviaMOG.txt"
MOM ="countries/MoldaviaMOM.txt"
ATJ ="countries/Atjeh.txt" 
ATH ="countries/AtjehATH.txt"
ATP ="countries/AtjehATP.txt"
OAX ="countries/Oaxaca.txt" 
OAU ="countries/OaxacaOAU.txt"
OAV ="countries/OaxacaOAV.txt"
UCA ="countries/UnitedStatesofCentralAmerica.txt" 
UCQ ="countries/UnitedStatesofCentralAmericaUCQ.txt"
UCI ="countries/UnitedStatesofCentralAmericaUCI.txt"
XHO ="countries/Xhosa.txt" 
XHD ="countries/XhosaXHD.txt"
XHW ="countries/XhosaXHW.txt"
MAD ="countries/Madagascar.txt" 
MAY ="countries/MadagascarMAY.txt"
MAR ="countries/MadagascarMAR.txt"
KAL ="countries/Kalat.txt" 
KAJ ="countries/KalatKAJ.txt"
KAD ="countries/KalatKAD.txt"
FRA ="countries/France.txt" 
FRP ="countries/FranceFRP.txt"
FRX ="countries/FranceFRX.txt"
UNB ="countries/Nebraska.txt" 
UNI ="countries/NebraskaUNI.txt"
UNZ ="countries/NebraskaUNZ.txt"
JAM ="countries/Jamaica.txt" 
JAK ="countries/JamaicaJAK.txt"
JAA ="countries/JamaicaJAA.txt"
NEN ="countries/NewEngland.txt" 
NEC ="countries/NewEnglandNEC.txt"
NES ="countries/NewEnglandNES.txt"
AOT ="countries/Aotearoa.txt" 
AOP ="countries/AotearoaAOP.txt"
AOA ="countries/AotearoaAOA.txt"
SIN ="countries/Sind.txt" 
SIO ="countries/SindSIO.txt"
SIV ="countries/SindSIV.txt"
MNP ="countries/Manipur.txt" 
MNF ="countries/ManipurMNF.txt"
MNT ="countries/ManipurMNT.txt"
SHW ="countries/Shewa.txt" 
SHV ="countries/ShewaSHV.txt"
SHF ="countries/ShewaSHF.txt"
PTG ="countries/Patagonia.txt" 
PTD ="countries/PatagoniaPTD.txt"
PTS ="countries/PatagoniaPTS.txt"
LOA ="countries/Loango.txt" 
LOG ="countries/LoangoLOG.txt"
LOI ="countries/LoangoLOI.txt"
PLS ="countries/Palestine.txt" 
PLZ ="countries/PalestinePLZ.txt"
PLD ="countries/PalestinePLD.txt"
LUN ="countries/Lunda.txt" 
LUG ="countries/LundaLUG.txt"
LUI ="countries/LundaLUI.txt"
ARC ="countries/ArgentineConfederation.txt" 
ARD ="countries/ArgentineConfederationARD.txt"
ARN ="countries/ArgentineConfederationARN.txt"
DON ="countries/Cossackia.txt" 
DOF ="countries/CossackiaDOF.txt"
DOD ="countries/CossackiaDOD.txt"
HAR ="countries/Harar.txt" 
HAK ="countries/HararHAK.txt"
HAD ="countries/HararHAD.txt"
SAT ="countries/Satsuma.txt" 
SAY ="countries/SatsumaSAY.txt"
SAA ="countries/SatsumaSAA.txt"
KRA ="countries/Krakow.txt" 
KRT ="countries/KrakowKRT.txt"
KRP ="countries/KrakowKRP.txt"
MDV ="countries/Moldova.txt" 
MDI ="countries/MoldovaMDI.txt"
MDL ="countries/MoldovaMDL.txt"
MAJ ="countries/Majeerteen.txt" 
MAV ="countries/MajeerteenMAV.txt"
MAW ="countries/MajeerteenMAW.txt"
BER ="countries/Beroda.txt" 
BET ="countries/BerodaBET.txt"
BEX ="countries/BerodaBEX.txt"
TOG ="countries/Togo.txt" 
TOE ="countries/TogoTOE.txt"
TOV ="countries/TogoTOV.txt"
TRN ="countries/Transvaal.txt" 
TRQ ="countries/TransvaalTRQ.txt"
TRL ="countries/TransvaalTRL.txt"
CPL ="countries/CongressPoland.txt" 
CPQ ="countries/CongressPolandCPQ.txt"
CPE ="countries/CongressPolandCPE.txt"
MCK ="countries/Manchukuo.txt" 
MCB ="countries/ManchukuoMCB.txt"
MCH ="countries/ManchukuoMCH.txt"
MTC ="countries/MetisConfederacy.txt" 
MTV ="countries/MetisConfederacyMTV.txt"
MTW ="countries/MetisConfederacyMTW.txt"
REB ="countries/rebels.txt" 
REP ="countries/rebelsREP.txt"
REC ="countries/rebelsREC.txt"
KHI ="countries/Khiva.txt" 
KHC ="countries/KhivaKHC.txt"
KHE ="countries/KhivaKHE.txt"
GXI ="countries/GuangxiClique.txt" 
GXY ="countries/GuangxiCliqueGXY.txt"
GXG ="countries/GuangxiCliqueGXG.txt"
KNY ="countries/Kenya.txt" 
KNE ="countries/KenyaKNE.txt"
KNJ ="countries/KenyaKNJ.txt"
WOL ="countries/Wolof.txt" 
WOQ ="countries/WolofWOQ.txt"
WOP ="countries/WolofWOP.txt"
DOM ="countries/DominicanRepublic.txt" 
DOS ="countries/DominicanRepublicDOS.txt"
DOK ="countries/DominicanRepublicDOK.txt"
JOH ="countries/Johore.txt" 
JOQ ="countries/JohoreJOQ.txt"
JOP ="countries/JohoreJOP.txt"
LIT ="countries/Lithuania.txt" 
LII ="countries/LithuaniaLII.txt"
LIM ="countries/LithuaniaLIM.txt"
SAR ="countries/Sardinia-Piedmont.txt" 
SAZ ="countries/Sardinia-PiedmontSAZ.txt"
SAV ="countries/Sardinia-PiedmontSAV.txt"
GBU ="countries/Gabu.txt" 
GBC ="countries/GabuGBC.txt"
GBB ="countries/GabuGBB.txt"
ALS ="countries/Elsass.txt" 
ALH ="countries/ElsassALH.txt"
ALM ="countries/ElsassALM.txt"
HUI ="countries/Anhui.txt" 
HUM ="countries/AnhuiHUM.txt"
HUX ="countries/AnhuiHUX.txt"
MKN ="countries/Mukriyan.txt" 
MKH ="countries/MukriyanMKH.txt"
MKR ="countries/MukriyanMKR.txt"
JAP ="countries/Japan.txt" 
JAC ="countries/JapanJAC.txt"
JAU ="countries/JapanJAU.txt"
HAI ="countries/Haiti.txt" 
HAS ="countries/HaitiHAS.txt"
HAH ="countries/HaitiHAH.txt"
MGH ="countries/Maghreb.txt" 
MGF ="countries/MaghrebMGF.txt"
MGX ="countries/MaghrebMGX.txt"
COB ="countries/Saxe-Coburg-Gotha.txt" 
COW ="countries/Saxe-Coburg-GothaCOW.txt"
COE ="countries/Saxe-Coburg-GothaCOE.txt"
SPA ="countries/Spain.txt" 
SPR ="countries/SpainSPR.txt"
SPV ="countries/SpainSPV.txt"
GNG ="countries/Guangdong.txt" 
GNO ="countries/GuangdongGNO.txt"
GNC ="countries/GuangdongGNC.txt"
LAD ="countries/Ladakh.txt" 
LAY ="countries/LadakhLAY.txt"
LAR ="countries/LadakhLAR.txt"
CHO ="countries/Choshu.txt" 
CHQ ="countries/ChoshuCHQ.txt"
CHV ="countries/ChoshuCHV.txt"
KRN ="countries/Karnatak.txt" 
KRX ="countries/KarnatakKRX.txt"
KRB ="countries/KarnatakKRB.txt"
RYU ="countries/Ryukyu.txt" 
RYE ="countries/RyukyuRYE.txt"
RYX ="countries/RyukyuRYX.txt"
UZB ="countries/Uzbekistan.txt" 
UZO ="countries/UzbekistanUZO.txt"
UZH ="countries/UzbekistanUZH.txt"
TSW ="countries/Botswana.txt" 
TSO ="countries/BotswanaTSO.txt"
TST ="countries/BotswanaTST.txt"
ROM ="countries/Romania.txt" 
ROW ="countries/RomaniaROW.txt"
ROX ="countries/RomaniaROX.txt"
IND ="countries/Indore.txt" 
INU ="countries/IndoreINU.txt"
INF ="countries/IndoreINF.txt"
URU ="countries/Uruguay.txt" 
URM ="countries/UruguayURM.txt"
URD ="countries/UruguayURD.txt"
URA ="countries/UralRepublic.txt" 
URS ="countries/UralRepublicURS.txt"
URZ ="countries/UralRepublicURZ.txt"
SCA ="countries/Scandinavia.txt" 
SCP ="countries/ScandinaviaSCP.txt"
SCU ="countries/ScandinaviaSCU.txt"
JOD ="countries/Jodhpur.txt" 
JOJ ="countries/JodhpurJOJ.txt"
JOS ="countries/JodhpurJOS.txt"
ASH ="countries/Ashanti.txt" 
ASP ="countries/AshantiASP.txt"
ASF ="countries/AshantiASF.txt"
TOO ="countries/Tooro.txt" 
TOM ="countries/TooroTOM.txt"
TOD ="countries/TooroTOD.txt"
CGO ="countries/Congo-Brazzaville.txt" 
CGI ="countries/Congo-BrazzavilleCGI.txt"
CGW ="countries/Congo-BrazzavilleCGW.txt"
AWS ="countries/Awsa.txt" 
AWX ="countries/AwsaAWX.txt"
AWY ="countries/AwsaAWY.txt"
EST ="countries/Estonia.txt" 
ESZ ="countries/EstoniaESZ.txt"
ESN ="countries/EstoniaESN.txt"
BDK ="countries/Badakhshan.txt" 
BDO ="countries/BadakhshanBDO.txt"
BDP ="countries/BadakhshanBDP.txt"
CRI ="countries/Crimea.txt" 
CRU ="countries/CrimeaCRU.txt"
CRZ ="countries/CrimeaCRZ.txt"
HDJ ="countries/Hedjaz.txt" 
HDT ="countries/HedjazHDT.txt"
HDX ="countries/HedjazHDX.txt"
DRA ="countries/Dravidistan.txt" 
DRH ="countries/DravidistanDRH.txt"
DRV ="countries/DravidistanDRV.txt"
CRE ="countries/Crete.txt" 
CRH ="countries/CreteCRH.txt"
CRX ="countries/CreteCRX.txt"
HAL ="countries/Hail.txt" 
HAZ ="countries/HailHAZ.txt"
HAC ="countries/HailHAC.txt"
SOM ="countries/Somalia.txt" 
SOB ="countries/SomaliaSOB.txt"
SOH ="countries/SomaliaSOH.txt"
HUN ="countries/Hungary.txt" 
HUH ="countries/HungaryHUH.txt"
HUO ="countries/HungaryHUO.txt"
KAG ="countries/Kaga.txt" 
KAE ="countries/KagaKAE.txt"
KAC ="countries/KagaKAC.txt"
KBO ="countries/Kanem-Bornu.txt" 
KBJ ="countries/Kanem-BornuKBJ.txt"
KBQ ="countries/Kanem-BornuKBQ.txt"
AKH ="countries/Astrakhan.txt" 
AKD ="countries/AstrakhanAKD.txt"
AKN ="countries/AstrakhanAKN.txt"
CZH ="countries/Czechoslovakia.txt" 
CZE ="countries/CzechoslovakiaCZE.txt"
CZG ="countries/CzechoslovakiaCZG.txt"
SHA ="countries/Shan.txt" 
SHP ="countries/ShanSHP.txt"
SHY ="countries/ShanSHY.txt"
BUK ="countries/Bukkhara.txt" 
BUE ="countries/BukkharaBUE.txt"
BUJ ="countries/BukkharaBUJ.txt"
SUD ="countries/Sudan.txt" 
SUR ="countries/SudanSUR.txt"
SUF ="countries/SudanSUF.txt"
PHG ="countries/Pahang.txt" 
PHY ="countries/PahangPHY.txt"
PHE ="countries/PahangPHE.txt"
ISR ="countries/Israel.txt" 
ISD ="countries/IsraelISD.txt"
ISP ="countries/IsraelISP.txt"
BOH ="countries/Bohemia-Moravia.txt" 
BOR ="countries/Bohemia-MoraviaBOR.txt"
BOZ ="countries/Bohemia-MoraviaBOZ.txt"
NMB ="countries/Namibia.txt" 
NMF ="countries/NamibiaNMF.txt"
NMN ="countries/NamibiaNMN.txt"
DJA ="countries/Jambi.txt" 
DJP ="countries/JambiDJP.txt"
DJC ="countries/JambiDJC.txt"
GAB ="countries/Gabon.txt" 
GAG ="countries/GabonGAG.txt"
GAP ="countries/GabonGAP.txt"
WAD ="countries/Wadai.txt" 
WAO ="countries/WadaiWAO.txt"
WAJ ="countries/WadaiWAJ.txt"
DAG ="countries/Dagestan.txt" 
DAT ="countries/DagestanDAT.txt"
DAL ="countries/DagestanDAL.txt"
PAP ="countries/PapalStates.txt" 
PAO ="countries/PapalStatesPAO.txt"
PAZ ="countries/PapalStatesPAZ.txt"
ARO ="countries/Aro.txt" 
ARW ="countries/AroARW.txt"
ARX ="countries/AroARX.txt"
XIN ="countries/Xinjiang.txt" 
XIV ="countries/XinjiangXIV.txt"
XIS ="countries/XinjiangXIS.txt"
BEL ="countries/Belgium.txt" 
BEA ="countries/BelgiumBEA.txt"
BEF ="countries/BelgiumBEF.txt"
RPL ="countries/Rupert'sLand.txt" 
RPJ ="countries/Rupert'sLandRPJ.txt"
RPN ="countries/Rupert'sLandRPN.txt"
CAR ="countries/CentralAfricanRepublic.txt" 
CAD ="countries/CentralAfricanRepublicCAD.txt"
CAB ="countries/CentralAfricanRepublicCAB.txt"
MYS ="countries/Mysore.txt" 
MYT ="countries/MysoreMYT.txt"
MYE ="countries/MysoreMYE.txt"
BIK ="countries/Bikaner.txt" 
BIS ="countries/BikanerBIS.txt"
BIM ="countries/BikanerBIM.txt"
HEK ="countries/Hesse-Kassel.txt" 
HEW ="countries/Hesse-KasselHEW.txt"
HEL ="countries/Hesse-KasselHEL.txt"
FIU ="countries/Fiume.txt" 
FIG ="countries/FiumeFIG.txt"
FIT ="countries/FiumeFIT.txt"
BRA ="countries/Braunschweig.txt" 
BRS ="countries/BraunschweigBRS.txt"
BRC ="countries/BraunschweigBRC.txt"
SPU ="countries/SouthPeru.txt" 
SPJ ="countries/SouthPeruSPJ.txt"
SPX ="countries/SouthPeruSPX.txt"
BOL ="countries/Bolivia.txt" 
BOU ="countries/BoliviaBOU.txt"
BOO ="countries/BoliviaBOO.txt"
ENG ="countries/UnitedKingdom.txt" 
ENS ="countries/UnitedKingdomENS.txt"
ENO ="countries/UnitedKingdomENO.txt"
LOM ="countries/Lombardia.txt" 
LOO ="countries/LombardiaLOO.txt"
LOQ ="countries/LombardiaLOQ.txt"
KUB ="countries/Kuba.txt" 
KUX ="countries/KubaKUX.txt"
KUQ ="countries/KubaKUQ.txt"
ECU ="countries/Ecuador.txt" 
ECW ="countries/EcuadorECW.txt"
ECK ="countries/EcuadorECK.txt"
NGR ="countries/Nigeria.txt" 
NGC ="countries/NigeriaNGC.txt"
NGW ="countries/NigeriaNGW.txt"
NAS ="countries/Nassau.txt" 
NAJ ="countries/NassauNAJ.txt"
NAP ="countries/NassauNAP.txt"
NOR ="countries/Norway.txt" 
NOT ="countries/NorwayNOT.txt"
NOX ="countries/NorwayNOX.txt"
FJN ="countries/Fujian.txt" 
FJD ="countries/FujianFJD.txt"
FJK ="countries/FujianFJK.txt"
HAN ="countries/Hanover.txt" 
HAE ="countries/HanoverHAE.txt"
HAV ="countries/HanoverHAV.txt"
TUN ="countries/Tunis.txt" 
TUO ="countries/TunisTUO.txt"
TUA ="countries/TunisTUA.txt"
KCH ="countries/Kachin.txt" 
KCW ="countries/KachinKCW.txt"
KCO ="countries/KachinKCO.txt"
RAJ ="countries/Rajputana.txt" 
RAK ="countries/RajputanaRAK.txt"
RAG ="countries/RajputanaRAG.txt"
WRL ="countries/Warsangali.txt" 
WRC ="countries/WarsangaliWRC.txt"
WRX ="countries/WarsangaliWRX.txt"
PRK ="countries/Perak.txt" 
PRS ="countries/PerakPRS.txt"
PRQ ="countries/PerakPRQ.txt"
SYC ="countries/Sicily.txt" 
SYE ="countries/SicilySYE.txt"
SYN ="countries/SicilySYN.txt"
LIP ="countries/Lippe-Detmold.txt" 
LIG ="countries/Lippe-DetmoldLIG.txt"
LIN ="countries/Lippe-DetmoldLIN.txt"
LIB ="countries/Liberia.txt" 
LIF ="countries/LiberiaLIF.txt"
LIE ="countries/LiberiaLIE.txt"
HES ="countries/Hesse-Darmstadt.txt" 
HET ="countries/Hesse-DarmstadtHET.txt"
HEZ ="countries/Hesse-DarmstadtHEZ.txt"
NIC ="countries/Nicaragua.txt" 
NIU ="countries/NicaraguaNIU.txt"
NIV ="countries/NicaraguaNIV.txt"
PEU ="countries/Peru.txt" 
PEO ="countries/PeruPEO.txt"
PEZ ="countries/PeruPEZ.txt"
CAT ="countries/Catalonia.txt" 
CAF ="countries/CataloniaCAF.txt"
CAX ="countries/CataloniaCAX.txt"
SWE ="countries/Sweden.txt" 
SWS ="countries/SwedenSWS.txt"
SWD ="countries/SwedenSWD.txt"
LUZ ="countries/Luzica.txt" 
LUQ ="countries/LuzicaLUQ.txt"
LUS ="countries/LuzicaLUS.txt"
BYZ ="countries/Byzantium.txt" 
BYX ="countries/ByzantiumBYX.txt"
BYN ="countries/ByzantiumBYN.txt"
BAV ="countries/Bavaria.txt" 
BAR ="countries/BavariaBAR.txt"
BAM ="countries/BavariaBAM.txt"
KAR ="countries/Karen.txt" 
KAI ="countries/KarenKAI.txt"
KAW ="countries/KarenKAW.txt"
DES ="countries/Deseret.txt" 
DER ="countries/DeseretDER.txt"
DEV ="countries/DeseretDEV.txt"
MLY ="countries/Malaya.txt" 
MLE ="countries/MalayaMLE.txt"
MLC ="countries/MalayaMLC.txt"
PBC ="countries/Peru-BoliviaConfederation.txt" 
PBJ ="countries/Peru-BoliviaConfederationPBJ.txt"
PBU ="countries/Peru-BoliviaConfederationPBU.txt"
KRL ="countries/Karelia.txt" 
KRH ="countries/KareliaKRH.txt"
KRR ="countries/KareliaKRR.txt"
PNM ="countries/Panama.txt" 
PNF ="countries/PanamaPNF.txt"
PNS ="countries/PanamaPNS.txt"
AFG ="countries/Afghanistan.txt" 
AFQ ="countries/AfghanistanAFQ.txt"
AFW ="countries/AfghanistanAFW.txt"
YAK ="countries/Yakutia.txt" 
YAL ="countries/YakutiaYAL.txt"
YAM ="countries/YakutiaYAM.txt"
FLA ="countries/Flanders.txt" 
FLG ="countries/FlandersFLG.txt"
FLS ="countries/FlandersFLS.txt"
KAM ="countries/Kamchatka.txt" 
KAX ="countries/KamchatkaKAX.txt"
KAU ="countries/KamchatkaKAU.txt"
LXA ="countries/LanXang.txt" 
LXH ="countries/LanXangLXH.txt"
LXS ="countries/LanXangLXS.txt"
QNG ="countries/QingChina.txt" 
QNI ="countries/QingChinaQNI.txt"
QNE ="countries/QingChinaQNE.txt"
JAS ="countries/Jaisalmer.txt" 
JAD ="countries/JaisalmerJAD.txt"
JAE ="countries/JaisalmerJAE.txt"
GRN ="countries/Greenland.txt" 
GRK ="countries/GreenlandGRK.txt"
GRT ="countries/GreenlandGRT.txt"
MLW ="countries/Malawi.txt" 
MLU ="countries/MalawiMLU.txt"
MLG ="countries/MalawiMLG.txt"
POL ="countries/Poland.txt" 
POK ="countries/PolandPOK.txt"
POF ="countries/PolandPOF.txt"
YEM ="countries/Yemen.txt" 
YEY ="countries/YemenYEY.txt"
YER ="countries/YemenYER.txt"
TKM ="countries/Turkmenistan.txt" 
TKP ="countries/TurkmenistanTKP.txt"
TKN ="countries/TurkmenistanTKN.txt"
CRL ="countries/Chitral.txt" 
CRR ="countries/ChitralCRR.txt"
CRK ="countries/ChitralCRK.txt"
YUC ="countries/Yucatan.txt" 
YUT ="countries/YucatanYUT.txt"
YUA ="countries/YucatanYUA.txt"
MCD ="countries/Macedonia.txt" 
MCG ="countries/MacedoniaMCG.txt"
MCQ ="countries/MacedoniaMCQ.txt"
VNZ ="countries/Venezuela.txt" 
VNI ="countries/VenezuelaVNI.txt"
VND ="countries/VenezuelaVND.txt"
CSA ="countries/CSA.txt" 
CSL ="countries/CSACSL.txt"
CSQ ="countries/CSACSQ.txt"
MEW ="countries/Mewar.txt" 
MET ="countries/MewarMET.txt"
MER ="countries/MewarMER.txt"
ORI ="countries/Orissa.txt" 
ORQ ="countries/OrissaORQ.txt"
ORP ="countries/OrissaORP.txt"
TRI ="countries/Tripoli.txt" 
TRO ="countries/TripoliTRO.txt"
TRG ="countries/TripoliTRG.txt"
ARG ="countries/Argentina.txt" 
ARP ="countries/ArgentinaARP.txt"
ARZ ="countries/ArgentinaARZ.txt"
BEN ="countries/Benin.txt" 
BEI ="countries/BeninBEI.txt"
BEH ="countries/BeninBEH.txt"
SVY ="countries/Savoy.txt" 
SVU ="countries/SavoySVU.txt"
SVN ="countries/SavoySVN.txt"
OMA ="countries/Oman.txt" 
OMT ="countries/OmanOMT.txt"
OMD ="countries/OmanOMD.txt"
BMK ="countries/Bamako.txt" 
BMX ="countries/BamakoBMX.txt"
BMZ ="countries/BamakoBMZ.txt"
MEC ="countries/Mecklenburg.txt" 
MEK ="countries/MecklenburgMEK.txt"
MEL ="countries/MecklenburgMEL.txt"
SAK ="countries/Siak.txt" 
SAQ ="countries/SiakSAQ.txt"
SAG ="countries/SiakSAG.txt"
HND ="countries/India.txt" 
HNW ="countries/IndiaHNW.txt"
HNH ="countries/IndiaHNH.txt"
MOR ="countries/Morocco.txt" 
MOW ="countries/MoroccoMOW.txt"
MOB ="countries/MoroccoMOB.txt"
PRI ="countries/PuertoRico.txt" 
PRC ="countries/PuertoRicoPRC.txt"
PRR ="countries/PuertoRicoPRR.txt"
ARU ="countries/ArabUnion.txt" 
ART ="countries/ArabUnionART.txt"
ARH ="countries/ArabUnionARH.txt"
TAI ="countries/Taiwan.txt" 
TAU ="countries/TaiwanTAU.txt"
TAM ="countries/TaiwanTAM.txt"
QAT ="countries/Qatar.txt" 
QAD ="countries/QatarQAD.txt"
QAN ="countries/QatarQAN.txt"
RGR ="countries/RioGrande.txt" 
RGW ="countries/RioGrandeRGW.txt"
RGE ="countries/RioGrandeRGE.txt"
LBA ="countries/Luba.txt" 
LBB ="countries/LubaLBB.txt"
LBV ="countries/LubaLBV.txt"
SLW ="countries/Sulawesi.txt" 
SLT ="countries/SulawesiSLT.txt"
SLP ="countries/SulawesiSLP.txt"
KWT ="countries/Kuwait.txt" 
KWL ="countries/KuwaitKWL.txt"
KWD ="countries/KuwaitKWD.txt"
TKG ="countries/ShogunateJapan.txt" 
TKL ="countries/ShogunateJapanTKL.txt"
TKX ="countries/ShogunateJapanTKX.txt"
AST ="countries/Australia.txt" 
ASI ="countries/AustraliaASI.txt"
ASL ="countries/AustraliaASL.txt"
SWI ="countries/Switzerland.txt" 
SWB ="countries/SwitzerlandSWB.txt"
SWP ="countries/SwitzerlandSWP.txt"
ALD ="countries/Aldjazair.txt" 
ALR ="countries/AldjazairALR.txt"
ALP ="countries/AldjazairALP.txt"
NGF ="countries/NorthGermanFed.txt" 
NGS ="countries/NorthGermanFedNGS.txt"
NGA ="countries/NorthGermanFedNGA.txt"
SHK ="countries/Shilluk.txt" 
SHD ="countries/ShillukSHD.txt"
SHJ ="countries/ShillukSHJ.txt"
TRA ="countries/Travancore.txt" 
TRR ="countries/TravancoreTRR.txt"
TRP ="countries/TravancoreTRP.txt"
GMB ="countries/Gambia.txt" 
GMT ="countries/GambiaGMT.txt"
GML ="countries/GambiaGML.txt"
PRG ="countries/Paraguay.txt" 
PRH ="countries/ParaguayPRH.txt"
PRW ="countries/ParaguayPRW.txt"
BRE ="countries/Bremen.txt" 
BRF ="countries/BremenBRF.txt"
BRW ="countries/BremenBRW.txt"
GUA ="countries/Guatemala.txt" 
GUV ="countries/GuatemalaGUV.txt"
GUU ="countries/GuatemalaGUU.txt"
LBN ="countries/Lebanon.txt" 
LBU ="countries/LebanonLBU.txt"
LBO ="countries/LebanonLBO.txt"
HAM ="countries/Hamburg.txt" 
HAT ="countries/HamburgHAT.txt"
HAB ="countries/HamburgHAB.txt"
DND ="countries/Dendi.txt" 
DNT ="countries/DendiDNT.txt"
DNI ="countries/DendiDNI.txt"
KTI ="countries/Kutai.txt" 
KTP ="countries/KutaiKTP.txt"
KTX ="countries/KutaiKTX.txt"
UBD ="countries/UnitedBalticProvinces.txt" 
UBC ="countries/UnitedBalticProvincesUBC.txt"
UBJ ="countries/UnitedBalticProvincesUBJ.txt"
CLA ="countries/Calabar.txt" 
CLH ="countries/CalabarCLH.txt"
CLT ="countries/CalabarCLT.txt"
ANG ="countries/Angola.txt" 
ANP ="countries/AngolaANP.txt"
ANB ="countries/AngolaANB.txt"
JAV ="countries/Java.txt" 
JAH ="countries/JavaJAH.txt"
JAY ="countries/JavaJAY.txt"
SER ="countries/Serbia.txt" 
SEB ="countries/SerbiaSEB.txt"
SEL ="countries/SerbiaSEL.txt"
BLC ="countries/Baluchistan.txt" 
BLM ="countries/BaluchistanBLM.txt"
BLL ="countries/BaluchistanBLL.txt"
COS ="countries/CostaRica.txt" 
COZ ="countries/CostaRicaCOZ.txt"
COX ="countries/CostaRicaCOX.txt"
HBY ="countries/Hobyo.txt" 
HBA ="countries/HobyoHBA.txt"
HBS ="countries/HobyoHBS.txt"
FIJ ="countries/Fiji.txt" 
FIX ="countries/FijiFIX.txt"
FIV ="countries/FijiFIV.txt"
CMR ="countries/Cameroon.txt" 
CMY ="countries/CameroonCMY.txt"
CMP ="countries/CameroonCMP.txt"
DZG ="countries/Danzig.txt" 
DZH ="countries/DanzigDZH.txt"
DZB ="countries/DanzigDZB.txt"
RHO ="countries/SouthernRhodesia.txt" 
RHC ="countries/SouthernRhodesiaRHC.txt"
RHG ="countries/SouthernRhodesiaRHG.txt"
NAG ="countries/Nagpur.txt" 
NAZ ="countries/NagpurNAZ.txt"
NAC ="countries/NagpurNAC.txt"
SUL ="countries/Sulu.txt" 
SUH ="countries/SuluSUH.txt"
SUE ="countries/SuluSUE.txt"
TIB ="countries/Tibet.txt" 
TIU ="countries/TibetTIU.txt"
TIY ="countries/TibetTIY.txt"
FRO ="countries/Faroe.txt" 
FRG ="countries/FaroeFRG.txt"
FRU ="countries/FaroeFRU.txt"
SLO ="countries/Slovenia.txt" 
SLJ ="countries/SloveniaSLJ.txt"
SLH ="countries/SloveniaSLH.txt"
TPG ="countries/Taiping.txt" 
TPR ="countries/TaipingTPR.txt"
TPO ="countries/TaipingTPO.txt"
ARM ="countries/Armenia.txt" 
ARJ ="countries/ArmeniaARJ.txt"
ARR ="countries/ArmeniaARR.txt"
UIL ="countries/Illinois.txt" 
UIY ="countries/IllinoisUIY.txt"
UIO ="countries/IllinoisUIO.txt"
GRE ="countries/Greece.txt" 
GRI ="countries/GreeceGRI.txt"
GRR ="countries/GreeceGRR.txt"
BOS ="countries/Bosnia-Herzegovina.txt" 
BOF ="countries/Bosnia-HerzegovinaBOF.txt"
BOD ="countries/Bosnia-HerzegovinaBOD.txt"
MAT ="countries/Matabele.txt" 
MAE ="countries/MatabeleMAE.txt"
MAM ="countries/MatabeleMAM.txt"
UOR ="countries/Oregon.txt" 
UON ="countries/OregonUON.txt"
UOS ="countries/OregonUOS.txt"
CYP ="countries/Cyprus.txt" 
CYA ="countries/CyprusCYA.txt"
CYV ="countries/CyprusCYV.txt"
SHO ="countries/Shona.txt" 
SHQ ="countries/ShonaSHQ.txt"
SHG ="countries/ShonaSHG.txt"
LPL ="countries/LaPlata.txt" 
LPZ ="countries/LaPlataLPZ.txt"
LPW ="countries/LaPlataLPW.txt"
WES ="countries/Westfalen.txt" 
WEX ="countries/WestfalenWEX.txt"
WEC ="countries/WestfalenWEC.txt"
COL ="countries/Columbia.txt" 
COJ ="countries/ColumbiaCOJ.txt"
COU ="countries/ColumbiaCOU.txt"
IRQ ="countries/Iraq.txt" 
IRN ="countries/IraqIRN.txt"
IRA ="countries/IraqIRA.txt"
BHT ="countries/Bohtan.txt" 
BHQ ="countries/BohtanBHQ.txt"
BHM ="countries/BohtanBHM.txt"
BAL ="countries/Bali.txt" 
BAZ ="countries/BaliBAZ.txt"
BAK ="countries/BaliBAK.txt"
WAL ="countries/Wallachia.txt" 
WAB ="countries/WallachiaWAB.txt"
WAF ="countries/WallachiaWAF.txt"
CAN ="countries/Canada.txt" 
CAJ ="countries/CanadaCAJ.txt"
CAP ="countries/CanadaCAP.txt"
KAF ="countries/Kaffa.txt" 
KAO ="countries/KaffaKAO.txt"
KAH ="countries/KaffaKAH.txt"
MAH ="countries/Maharashtra.txt" 
MAU ="countries/MaharashtraMAU.txt"
MAI ="countries/MaharashtraMAI.txt"
RWA ="countries/Ruanda.txt" 
RWM ="countries/RuandaRWM.txt"
RWW ="countries/RuandaRWW.txt"
KOR ="countries/Korea.txt" 
KOP ="countries/KoreaKOP.txt"
KOC ="countries/KoreaKOC.txt"
BRU ="countries/Brunei.txt" 
BRH ="countries/BruneiBRH.txt"
BRI ="countries/BruneiBRI.txt"
ABK ="countries/Abkhazia.txt" 
ABO ="countries/AbkhaziaABO.txt"
ABJ ="countries/AbkhaziaABJ.txt"
KDS ="countries/Kurdistan.txt" 
KDH ="countries/KurdistanKDH.txt"
KDT ="countries/KurdistanKDT.txt"
CLC ="countries/Cilicia.txt" 
CLN ="countries/CiliciaCLN.txt"
CLR ="countries/CiliciaCLR.txt"
CHK ="countries/Champasak.txt" 
CHM ="countries/ChampasakCHM.txt"
CHT ="countries/ChampasakCHT.txt"
ANH ="countries/Anhalt.txt" 
ANV ="countries/AnhaltANV.txt"
ANU ="countries/AnhaltANU.txt"
TRE ="countries/Trieste.txt" 
TRJ ="countries/TriesteTRJ.txt"
TRV ="countries/TriesteTRV.txt"
MUG ="countries/Mughalistan.txt" 
MUK ="countries/MughalistanMUK.txt"
MUP ="countries/MughalistanMUP.txt"
BDN ="countries/Bahdinan.txt" 
BDW ="countries/BahdinanBDW.txt"
BDX ="countries/BahdinanBDX.txt"
MAS ="countries/Massina.txt" 
MAN ="countries/MassinaMAN.txt"
MAQ ="countries/MassinaMAQ.txt"
ZUL ="countries/Zulu.txt" 
ZUA ="countries/ZuluZUA.txt"
ZUI ="countries/ZuluZUI.txt"
WHA ="countries/Wales.txt" 
WHG ="countries/WalesWHG.txt"
WHQ ="countries/WalesWHQ.txt"
WIA ="countries/WiangChhan.txt" 
WIY ="countries/WiangChhanWIY.txt"
WIL ="countries/WiangChhanWIL.txt"
XBI ="countries/XibeiSanMa.txt" 
XBN ="countries/XibeiSanMaXBN.txt"
XBR ="countries/XibeiSanMaXBR.txt"
FDL ="countries/Fadhli.txt" 
FDD ="countries/FadhliFDD.txt"
FDH ="countries/FadhliFDH.txt"
KAZ ="countries/Kazakhstan.txt" 
KAP ="countries/KazakhstanKAP.txt"
KAQ ="countries/KazakhstanKAQ.txt"
WUR ="countries/Wurttemberg.txt" 
WUL ="countries/WurttembergWUL.txt"
WUK ="countries/WurttembergWUK.txt"
LUA ="countries/LuangPrabang.txt" 
LUE ="countries/LuangPrabangLUE.txt"
LUJ ="countries/LuangPrabangLUJ.txt"
BSQ ="countries/Basqueland.txt" 
BSP ="countries/BasquelandBSP.txt"
BSS ="countries/BasquelandBSS.txt"
JAI ="countries/Jaipur.txt" 
JAW ="countries/JaipurJAW.txt"
JAT ="countries/JaipurJAT.txt"
ENT ="countries/EntreRios.txt" 
ENP ="countries/EntreRiosENP.txt"
ENZ ="countries/EntreRiosENZ.txt"
MHR ="countries/Mahra.txt" 
MHV ="countries/MahraMHV.txt"
MHD ="countries/MahraMHD.txt"
CRS ="countries/Corsica.txt" 
CRC ="countries/CorsicaCRC.txt"
CRY ="countries/CorsicaCRY.txt"
PLC ="countries/Poland-Lithuania.txt" 
PLL ="countries/Poland-LithuaniaPLL.txt"
PLW ="countries/Poland-LithuaniaPLW.txt"
YUG ="countries/Yugoslavia.txt" 
YUV ="countries/YugoslaviaYUV.txt"
YUI ="countries/YugoslaviaYUI.txt"
MOZ ="countries/Mozambique.txt" 
MOX ="countries/MozambiqueMOX.txt"
MOK ="countries/MozambiqueMOK.txt"
TOS ="countries/Tosa.txt" 
TOR ="countries/TosaTOR.txt"
TOF ="countries/TosaTOF.txt"
TAR ="countries/Tatarstan.txt" 
TAZ ="countries/TatarstanTAZ.txt"
TAW ="countries/TatarstanTAW.txt"
SGF ="countries/SouthGermanFed.txt" 
SGV ="countries/SouthGermanFedSGV.txt"
SGE ="countries/SouthGermanFedSGE.txt"
RDL ="countries/Ardalan.txt" 
RDK ="countries/ArdalanRDK.txt"
RDZ ="countries/ArdalanRDZ.txt"
EGY ="countries/Egypt.txt" 
EGS ="countries/EgyptEGS.txt"
EGH ="countries/EgyptEGH.txt"
HOL ="countries/Holstein.txt" 
HOS ="countries/HolsteinHOS.txt"
HOC ="countries/HolsteinHOC.txt"
EZO ="countries/Ezo.txt" 
EZY ="countries/EzoEZY.txt"
EZK ="countries/EzoEZK.txt"
BRZ ="countries/Brazil.txt" 
BRQ ="countries/BrazilBRQ.txt"
BRV ="countries/BrazilBRV.txt"
PZN ="countries/Poznan.txt" 
PZQ ="countries/PoznanPZQ.txt"
PZS ="countries/PoznanPZS.txt"
LUX ="countries/Luxemburg.txt" 
LUV ="countries/LuxemburgLUV.txt"
LUO ="countries/LuxemburgLUO.txt"
PML ="countries/Pomerelia.txt" 
PMK ="countries/PomereliaPMK.txt"
PMQ ="countries/PomereliaPMQ.txt"
ENL ="countries/England.txt" 
ENV ="countries/EnglandENV.txt"
ENK ="countries/EnglandENK.txt"
SGM ="countries/Sigmaringen.txt" 
SGW ="countries/SigmaringenSGW.txt"
SGZ ="countries/SigmaringenSGZ.txt"
ASM ="countries/Assam.txt" 
ASC ="countries/AssamASC.txt"
ASV ="countries/AssamASV.txt"
GON ="countries/Gonder.txt" 
GOE ="countries/GonderGOE.txt"
GOC ="countries/GonderGOC.txt"
BAN ="countries/Banat.txt" 
BAW ="countries/BanatBAW.txt"
BAX ="countries/BanatBAX.txt"
RUS ="countries/Russia.txt" 
RUW ="countries/RussiaRUW.txt"
RUL ="countries/RussiaRUL.txt"
AZB ="countries/Azerbaijan.txt" 
AZL ="countries/AzerbaijanAZL.txt"
AZD ="countries/AzerbaijanAZD.txt"
KOK ="countries/Kokand.txt" 
KOM ="countries/KokandKOM.txt"
KOO ="countries/KokandKOO.txt"
DEN ="countries/Denmark.txt" 
DEF ="countries/DenmarkDEF.txt"
DEI ="countries/DenmarkDEI.txt"
DAR ="countries/Darfur.txt" 
DAZ ="countries/DarfurDAZ.txt"
DAU ="countries/DarfurDAU.txt"
HYD ="countries/Hyderabad.txt" 
HYQ ="countries/HyderabadHYQ.txt"
HYL ="countries/HyderabadHYL.txt"
CAL ="countries/CalifornianRepublic.txt" 
CAH ="countries/CalifornianRepublicCAH.txt"
CAU ="countries/CalifornianRepublicCAU.txt"
ABU ="countries/AbuDhabi.txt" 
ABF ="countries/AbuDhabiABF.txt"
ABH ="countries/AbuDhabiABH.txt"
HAW ="countries/Hawaii.txt" 
HAY ="countries/HawaiiHAY.txt"
HAQ ="countries/HawaiiHAQ.txt"
SLG ="countries/Selangor.txt" 
SLC ="countries/SelangorSLC.txt"
SLF ="countries/SelangorSLF.txt"
BRT ="countries/Brittany.txt" 
BRB ="countries/BrittanyBRB.txt"
BRG ="countries/BrittanyBRG.txt"
ION ="countries/IonianIslands.txt" 
IOE ="countries/IonianIslandsIOE.txt"
IOW ="countries/IonianIslandsIOW.txt"
SWH ="countries/Schleswig-Holstein.txt" 
SWU ="countries/Schleswig-HolsteinSWU.txt"
SWQ ="countries/Schleswig-HolsteinSWQ.txt"
PNT ="countries/Pontus.txt" 
PNL ="countries/PontusPNL.txt"
PNK ="countries/PontusPNK.txt"
SAF ="countries/SouthAfrica.txt" 
SAD ="countries/SouthAfricaSAD.txt"
SAJ ="countries/SouthAfricaSAJ.txt"
LOS ="countries/LosAltos.txt" 
LOW ="countries/LosAltosLOW.txt"
LOE ="countries/LosAltosLOE.txt"
SLS ="countries/Silesia.txt" 
SLB ="countries/SilesiaSLB.txt"
SLU ="countries/SilesiaSLU.txt"
BRD ="countries/Urundi.txt" 
BRP ="countries/UrundiBRP.txt"
BRO ="countries/UrundiBRO.txt"
MEI ="countries/Saxe-Meiningen.txt" 
MEV ="countries/Saxe-MeiningenMEV.txt"
MEM ="countries/Saxe-MeiningenMEM.txt"
OYO ="countries/Oyo.txt" 
OYA ="countries/OyoOYA.txt"
OYH ="countries/OyoOYH.txt"
MOD ="countries/Modena.txt" 
MOI ="countries/ModenaMOI.txt"
MOQ ="countries/ModenaMOQ.txt"
ORA ="countries/Oranje.txt" 
ORU ="countries/OranjeORU.txt"
ORS ="countries/OranjeORS.txt"
TUS ="countries/Tuscany.txt" 
TUG ="countries/TuscanyTUG.txt"
TUX ="countries/TuscanyTUX.txt"
BAS ="countries/Bastar.txt" 
BAF ="countries/BastarBAF.txt"
BAO ="countries/BastarBAO.txt"
MLI ="countries/Mali.txt" 
MLK ="countries/MaliMLK.txt"
MLR ="countries/MaliMLR.txt"
TMR ="countries/Timor.txt" 
TMX ="countries/TimorTMX.txt"
TMK ="countries/TimorTMK.txt"
NZL ="countries/NewZealand.txt" 
NZS ="countries/NewZealandNZS.txt"
NZV ="countries/NewZealandNZV.txt"
BAD ="countries/Baden.txt" 
BAA ="countries/BadenBAA.txt"
BAY ="countries/BadenBAY.txt"
DAK ="countries/Dakota.txt" 
DAC ="countries/DakotaDAC.txt"
DAW ="countries/DakotaDAW.txt"
CIR ="countries/Circassia.txt" 
CIE ="countries/CircassiaCIE.txt"
CIQ ="countries/CircassiaCIQ.txt"
MLT ="countries/Malta.txt" 
MLZ ="countries/MaltaMLZ.txt"
MLM ="countries/MaltaMLM.txt"
SLV ="countries/Slovakia.txt" 
SLQ ="countries/SlovakiaSLQ.txt"
SLI ="countries/SlovakiaSLI.txt"
SON ="countries/Sonora.txt" 
SOJ ="countries/SonoraSOJ.txt"
SOG ="countries/SonoraSOG.txt"
AUS ="countries/Austria.txt" 
AUT ="countries/AustriaAUT.txt"
AUG ="countries/AustriaAUG.txt"
LUB ="countries/Lubeck.txt" 
LUL ="countries/LubeckLUL.txt"
LUK ="countries/LubeckLUK.txt"
PNB ="countries/Pernambuco.txt" 
PNC ="countries/PernambucoPNC.txt"
PNA ="countries/PernambucoPNA.txt"
MLD ="countries/Maldives.txt" 
MLQ ="countries/MaldivesMLQ.txt"
MLA ="countries/MaldivesMLA.txt"
NCT ="countries/Neuchatel.txt" 
NCH ="countries/NeuchatelNCH.txt"
NCX ="countries/NeuchatelNCX.txt"
IVC ="countries/IvoryCoast.txt" 
IVB ="countries/IvoryCoastIVB.txt"
IVI ="countries/IvoryCoastIVI.txt"
ATR ="countries/Asturias.txt" 
ATT ="countries/AsturiasATT.txt"
ATK ="countries/AsturiasATK.txt"
TOU ="countries/Toucouleur.txt" 
TOT ="countries/ToucouleurTOT.txt"
TOX ="countries/ToucouleurTOX.txt"
YNN ="countries/Yunnan.txt" 
YNV ="countries/YunnanYNV.txt"
YNH ="countries/YunnanYNH.txt"
POR ="countries/Portugal.txt" 
POG ="countries/PortugalPOG.txt"
POP ="countries/PortugalPOP.txt"
ALB ="countries/Albania.txt" 
ALO ="countries/AlbaniaALO.txt"
ALC ="countries/AlbaniaALC.txt"
CHY ="countries/Chechnya.txt" 
CHR ="countries/ChechnyaCHR.txt"
CHC ="countries/ChechnyaCHC.txt"
IZH ="countries/Ingria.txt" 
IZC ="countries/IngriaIZC.txt"
IZJ ="countries/IngriaIZJ.txt"
KNG ="countries/Kong.txt" 
KNK ="countries/KongKNK.txt"
KNI ="countries/KongKNI.txt"
CEQ ="countries/EquadorConfederation.txt" 
CEM ="countries/EquadorConfederationCEM.txt"
CEO ="countries/EquadorConfederationCEO.txt"
CYR ="countries/Cyrenaica.txt" 
CYW ="countries/CyrenaicaCYW.txt"
CYJ ="countries/CyrenaicaCYJ.txt"
PRU ="countries/Prussia.txt" 
PRD ="countries/PrussiaPRD.txt"
PRV ="countries/PrussiaPRV.txt"
SCO ="countries/Scotland.txt" 
SCB ="countries/ScotlandSCB.txt"
SCI ="countries/ScotlandSCI.txt"
ITA ="countries/Italy.txt" 
ITH ="countries/ItalyITH.txt"
ITS ="countries/ItalyITS.txt"
KAS ="countries/Kashmir.txt" 
KAT ="countries/KashmirKAT.txt"
KAB ="countries/KashmirKAB.txt"
USA ="countries/USA.txt" 
USV ="countries/USAUSV.txt"
USI ="countries/USAUSI.txt"
TKS ="countries/Turkestan.txt" 
TKF ="countries/TurkestanTKF.txt"
TKT ="countries/TurkestanTKT.txt"
PAR ="countries/Parma.txt" 
PAB ="countries/ParmaPAB.txt"
PAS ="countries/ParmaPAS.txt"
HON ="countries/Honduras.txt" 
HOM ="countries/HondurasHOM.txt"
HOF ="countries/HondurasHOF.txt"
RMG ="countries/Romagna.txt" 
RMR ="countries/RomagnaRMR.txt"
RMO ="countries/RomagnaRMO.txt"
MNG ="countries/Mongo.txt" 
MNN ="countries/MongoMNN.txt"
MNU ="countries/MongoMNU.txt"
BTL ="countries/Bitlis.txt" 
BTB ="countries/BitlisBTB.txt"
BTQ ="countries/BitlisBTQ.txt"
SCH ="countries/Schleswig.txt" 
SCZ ="countries/SchleswigSCZ.txt"
SCQ ="countries/SchleswigSCQ.txt"
CHD ="countries/Chad.txt" 
CHN ="countries/ChadCHN.txt"
CHB ="countries/ChadCHB.txt"
KUK ="countries/Austria-Hungary.txt" 
KUE ="countries/Austria-HungaryKUE.txt"
KUM ="countries/Austria-HungaryKUM.txt"
SXI ="countries/Shanxi.txt" 
SXZ ="countries/ShanxiSXZ.txt"
SXE ="countries/ShanxiSXE.txt"
AWA ="countries/Awadh.txt" 
AWT ="countries/AwadhAWT.txt"
AWR ="countries/AwadhAWR.txt"
LOR ="countries/Lorraine.txt" 
LOV ="countries/LorraineLOV.txt"
LOX ="countries/LorraineLOX.txt"
LUC ="countries/Lucca.txt" 
LUF ="countries/LuccaLUF.txt"
LUM ="countries/LuccaLUM.txt"
NYE ="countries/NorthYemen.txt" 
NYR ="countries/NorthYemenNYR.txt"
NYC ="countries/NorthYemenNYC.txt"
SEN ="countries/Sendai.txt" 
SEJ ="countries/SendaiSEJ.txt"
SEI ="countries/SendaiSEI.txt"
TEX ="countries/Texas.txt" 
TES ="countries/TexasTES.txt"
TEI ="countries/TexasTEI.txt"
LSK ="countries/Alaska.txt" 
LST ="countries/AlaskaLST.txt"
LSW ="countries/AlaskaLSW.txt"
SHI ="countries/Shimla.txt" 
SHL ="countries/ShimlaSHL.txt"
SHX ="countries/ShimlaSHX.txt"
DNB ="countries/DanubianFederation.txt" 
DNP ="countries/DanubianFederationDNP.txt"
DNZ ="countries/DanubianFederationDNZ.txt"
TIG ="countries/Tigray.txt" 
TIF ="countries/TigrayTIF.txt"
TIR ="countries/TigrayTIR.txt"
GER ="countries/Germany.txt" 
GEQ ="countries/GermanyGEQ.txt"
GED ="countries/GermanyGED.txt"
GEO ="countries/Georgia.txt" 
GEM ="countries/GeorgiaGEM.txt"
GEH ="countries/GeorgiaGEH.txt"
SNZ ="countries/SouthIsland.txt" 
SNM ="countries/SouthIslandSNM.txt"
SNT ="countries/SouthIslandSNT.txt"
SEG ="countries/Segu.txt" 
SEZ ="countries/SeguSEZ.txt"
SEQ ="countries/SeguSEQ.txt"
KUT ="countries/Kutch.txt" 
KUO ="countries/KutchKUO.txt"
KUP ="countries/KutchKUP.txt"
KZB ="countries/Kazembe.txt" 
KZL ="countries/KazembeKZL.txt"
KZO ="countries/KazembeKZO.txt"
LBY ="countries/Libya.txt" 
LBP ="countries/LibyaLBP.txt"
LBI ="countries/LibyaLBI.txt"
ASY ="countries/Assyria.txt" 
ASX ="countries/AssyriaASX.txt"
ASS ="countries/AssyriaASS.txt"
FRM ="countries/FrankfurtamMain.txt" 
FRV ="countries/FrankfurtamMainFRV.txt"
FRJ ="countries/FrankfurtamMainFRJ.txt"
NIG ="countries/Niger.txt" 
NIL ="countries/NigerNIL.txt"
NIR ="countries/NigerNIR.txt"
PER ="countries/Persia.txt" 
PEX ="countries/PersiaPEX.txt"
PEP ="countries/PersiaPEP.txt"
MEX ="countries/Mexico.txt" 
MED ="countries/MexicoMED.txt"
MEY ="countries/MexicoMEY.txt"
TNZ ="countries/Tanzania.txt" 
TNX ="countries/TanzaniaTNX.txt"
TNW ="countries/TanzaniaTNW.txt"
CNG ="countries/CongoFreeState.txt" 
CNE ="countries/CongoFreeStateCNE.txt"
CNQ ="countries/CongoFreeStateCNQ.txt"
BHO ="countries/Bhopal.txt" 
BHV ="countries/BhopalBHV.txt"
BHF ="countries/BhopalBHF.txt"
WLL ="countries/Wallonia.txt" 
WLH ="countries/WalloniaWLH.txt"
WLI ="countries/WalloniaWLI.txt"
ELS ="countries/ElSalvador.txt" 
ELQ ="countries/ElSalvadorELQ.txt"
ELC ="countries/ElSalvadorELC.txt"
PAK ="countries/Pakistan.txt" 
PAA ="countries/PakistanPAA.txt"
PAQ ="countries/PakistanPAQ.txt"
TCA ="countries/Transcaucasia.txt" 
TCI ="countries/TranscaucasiaTCI.txt"
TCG ="countries/TranscaucasiaTCG.txt"
LHJ ="countries/Lahej.txt" 
LHG ="countries/LahejLHG.txt"
LHH ="countries/LahejLHH.txt"
CRT ="countries/Corrientes.txt" 
CRA ="countries/CorrientesCRA.txt"
CRQ ="countries/CorrientesCRQ.txt"
YZW ="countries/Yonezawa.txt" 
YZU ="countries/YonezawaYZU.txt"
YZN ="countries/YonezawaYZN.txt"
SPC ="countries/CarlistSpain.txt" 
SPY ="countries/CarlistSpainSPY.txt"
SPW ="countries/CarlistSpainSPW.txt"
DAI ="countries/DaiViet.txt" 
DAS ="countries/DaiVietDAS.txt"
DAA ="countries/DaiVietDAA.txt"
ZAN ="countries/Zanzibar.txt" 
ZAJ ="countries/ZanzibarZAJ.txt"
ZAY ="countries/ZanzibarZAY.txt"
ICL ="countries/Iceland.txt" 
ICE ="countries/IcelandICE.txt"
ICG ="countries/IcelandICG.txt"
SIA ="countries/Siam.txt" 
SIX ="countries/SiamSIX.txt"
SIS ="countries/SiamSIS.txt"
BIH ="countries/Bihar.txt" 
BID ="countries/BiharBID.txt"
BIN ="countries/BiharBIN.txt"
CRO ="countries/Croatia.txt" 
CRW ="countries/CroatiaCRW.txt"
CRV ="countries/CroatiaCRV.txt"
QUE ="countries/Quebec.txt" 
QUQ ="countries/QuebecQUQ.txt"
QUP ="countries/QuebecQUP.txt"
SLE ="countries/SierraLeone.txt" 
SLM ="countries/SierraLeoneSLM.txt"
SLD ="countries/SierraLeoneSLD.txt"
FIN ="countries/Finland.txt" 
FIQ ="countries/FinlandFIQ.txt"
FIS ="countries/FinlandFIS.txt"
GNE ="countries/Guinea.txt" 
GNB ="countries/GuineaGNB.txt"
GNS ="countries/GuineaGNS.txt"
MAK ="countries/Makran.txt" 
MAO ="countries/MakranMAO.txt"
MAB ="countries/MakranMAB.txt"
DAH ="countries/Dahomey.txt" 
DAY ="countries/DahomeyDAY.txt"
DAJ ="countries/DahomeyDAJ.txt"
ETH ="countries/Ethiopia.txt" 
ETC ="countries/EthiopiaETC.txt"
ETO ="countries/EthiopiaETO.txt"
IRE ="countries/Ireland.txt" 
IRT ="countries/IrelandIRT.txt"
IRW ="countries/IrelandIRW.txt"
UYG ="countries/Uyghurstan.txt" 
UYE ="countries/UyghurstanUYE.txt"
UYU ="countries/UyghurstanUYU.txt"
SIC ="countries/TwoSicilies.txt" 
SIG ="countries/TwoSiciliesSIG.txt"
SII ="countries/TwoSiciliesSII.txt"
NET ="countries/Netherlands.txt" 
NEE ="countries/NetherlandsNEE.txt"
NEF ="countries/NetherlandsNEF.txt"
ZAM ="countries/Zambia.txt" 
ZAD ="countries/ZambiaZAD.txt"
ZAK ="countries/ZambiaZAK.txt"
GWA ="countries/Gwailor.txt" 
GWG ="countries/GwailorGWG.txt"
GWM ="countries/GwailorGWM.txt"
SUA ="countries/Suazi.txt" 
SUZ ="countries/SuaziSUZ.txt"
SUQ ="countries/SuaziSUQ.txt"
BUN ="countries/Bundelkhand.txt" 
BUS ="countries/BundelkhandBUS.txt"
BUT ="countries/BundelkhandBUT.txt"
SZC ="countries/Sichuan.txt" 
SZB ="countries/SichuanSZB.txt"
SZR ="countries/SichuanSZR.txt"
NEJ ="countries/Nejd.txt" 
NEQ ="countries/NejdNEQ.txt"
NEX ="countries/NejdNEX.txt"
JOR ="countries/Jordan.txt" 
JOE ="countries/JordanJOE.txt"
JOY ="countries/JordanJOY.txt"
PGG ="countries/PingnanGuo.txt" 
PGW ="countries/PingnanGuoPGW.txt"
PGQ ="countries/PingnanGuoPGQ.txt"
NEW ="countries/Newfoundland.txt" 
NEL ="countries/NewfoundlandNEL.txt"
NEO ="countries/NewfoundlandNEO.txt"
RHI ="countries/Rhineland.txt" 
RHK ="countries/RhinelandRHK.txt"
RHJ ="countries/RhinelandRHJ.txt"
WEI ="countries/Saxe-Weimar.txt" 
WEB ="countries/Saxe-WeimarWEB.txt"
WEP ="countries/Saxe-WeimarWEP.txt"
BUG ="countries/Buganda.txt" 
BUF ="countries/BugandaBUF.txt"
BUD ="countries/BugandaBUD.txt"
BNG ="countries/Bengal.txt" 
BNR ="countries/BengalBNR.txt"
BNP ="countries/BengalBNP.txt"
BRY ="countries/Buryatia.txt" 
BRK ="countries/BuryatiaBRK.txt"
BRN ="countries/BuryatiaBRN.txt"
MON ="countries/Montenegro.txt" 
MOV ="countries/MontenegroMOV.txt"
MOH ="countries/MontenegroMOH.txt"
CUB ="countries/Cuba.txt" 
CUI ="countries/CubaCUI.txt"
CUL ="countries/CubaCUL.txt"
UKR ="countries/Ukraine.txt" 
UKT ="countries/UkraineUKT.txt"
UKB ="countries/UkraineUKB.txt"
SRN ="countries/Soran.txt" 
SRQ ="countries/SoranSRQ.txt"
SRA ="countries/SoranSRA.txt"
